NO ./path
SO ./path
WE ./path
DO       ./textures/sprite

EA ./path
F 0,0,0
C 0,0,0

1111111
1E02201
1111111
