     NO textures/bluewall.xpm
     SO textures/scream
WE textures/purplestone.xpm
EA textures/mossy.xpm

DO textures/eagle.xpm

EX textures/sprite

F 192,192,192
C 100,100,255


        1111111111111111111111111
        1000000000110000000000001
        1211000001110001111110001
        1001000002020000000000001
111111111211000001110000000000001
1X0000200011000001112111111111111
1111011111111101110000001000101
1111211111111101110101002010111
11000000110101011100000010001
10011100000000000000000010001
10011100000000001101010010001
1100000111010121111101111000111
11110111 1110101 101111010001
11111111 1110111 1111110011011
        1111011111111110000111111
        1000000000110000000000001
        1211001001110000111111101
        1001001002020000102020101
111111111011000001110000121111101
100000000011000001112111101011111
11112111111111011100000010001
11110111111111011101010020001
11000000110101011100000010001
10011100000000000200000010001
10011100000000001101010010001
110000011101210111110112100111
11110111 1110101 1011110100W1
11111111 1111111 111111111111

