     NO textures/bluewall.xpm
     SO textures/bluewall.xpm
WE textures/bluewall.xpm
EA textures/bluewall.xpm




F 225,255,255
C 0,0,0


        1111111111111111111111111
        1000000000110000000000001
        1011000001110000000000001
        1001000000000000000000001
111111111011000001110000000000001
100000000011000001110111111111111
11110111111111011100000010001
11110111111111011101010000001
11000000110101011100000010001
10000000000000000000000010001
10000000000000001101010010001
1100000111010101111101111000111
11110111 1110101 101111010001
11111111 1110111 111111101111
        1111011111111111111111111
        1000000000110000000000001
        1011000001110000100000001
        1001000000000000110000001
11111111101100000111E000000000001
100000000011000001110111111111111
11110111111111011100000010001
11110111111111011101010000001
11000000110101011100000010001
10000000000000000000000010001
10000000000000001101010010001
110000011101010111110111100111
11110111 1110101 101111010001
11111111 1111111 111111111111
